奈良市	www.city.nara.lg.jp
大和高田市	www.city.yamatotakada.nara.jp
大和郡山市	www.city.yamatokoriyama.lg.jp
天理市	www.city.tenri.nara.jp
橿原市	www.city.kashihara.nara.jp
桜井市	www.city.sakurai.lg.jp
五條市	www.city.gojo.lg.jp
御所市	www.city.gose.nara.jp
生駒市	www.city.ikoma.lg.jp
香芝市	www.city.kashiba.lg.jp
葛城市	www.city.katsuragi.nara.jp
宇陀市	www.city.uda.nara.jp
山添村	www.vill.yamazoe.nara.jp
平群町	www.town.heguri.nara.jp
三郷町	www.town.sango.nara.jp
斑鳩町	www.town.ikaruga.nara.jp
安堵町	www.town.ando.nara.jp
川西町	www.town.nara-kawanishi.lg.jp
三宅町	www.town.miyake.lg.jp
田原本町	www.town.tawaramoto.nara.jp
曽爾村	www.vill.soni.nara.jp
御杖村	www.vill.mitsue.nara.jp
高取町	www.town.takatori.nara.jp
明日香村	asukamura.jp
上牧町	www.town.kanmaki.nara.jp
王寺町	www.town.oji.nara.jp
広陵町	www.town.koryo.nara.jp
河合町	www.town.kawai.nara.jp
吉野町	www.town.yoshino.nara.jp
大淀町	www.town.oyodo.lg.jp
下市町	www.town.shimoichi.lg.jp
黒滝村	www.vill.kurotaki.nara.jp
天川村	www.vill.tenkawa.nara.jp
野迫川村	www.vill.nosegawa.nara.jp
十津川村	www.vill.totsukawa.lg.jp
下北山村	www.vill.shimokitayama.nara.jp
上北山村	vill.kamikitayama.nara.jp
川上村	www.vill.kawakami.nara.jp
東吉野村	www.vill.higashiyoshino.nara.jp
