岡山市	www.city.okayama.jp
倉敷市	www.city.kurashiki.okayama.jp
津山市	www.city.tsuyama.lg.jp
玉野市	www.city.tamano.lg.jp
笠岡市	www.city.kasaoka.okayama.jp
井原市	www.city.ibara.okayama.jp
総社市	www.city.soja.okayama.jp
高梁市	www.city.takahashi.lg.jp
新見市	www.city.niimi.okayama.jp
備前市	www.city.bizen.okayama.jp
瀬戸内市	www.city.setouchi.lg.jp
赤磐市	www.city.akaiwa.lg.jp
真庭市	www.city.maniwa.lg.jp
美作市	www.city.mimasaka.lg.jp
浅口市	www.city.asakuchi.lg.jp
和気町	www.town.wake.lg.jp
早島町	www.town.hayashima.lg.jp
里庄町	www.town.satosho.okayama.jp
矢掛町	www.town.yakage.okayama.jp
新庄村	www.vill.shinjo.okayama.jp
鏡野町	www.town.kagamino.lg.jp
勝央町	www.town.shoo.lg.jp
奈義町	www.town.nagi.okayama.jp
西粟倉村	www.vill.nishiawakura.okayama.jp
久米南町	www.town.kumenan.lg.jp
美咲町	www.town.misaki.okayama.jp
吉備中央町	www.town.kibichuo.lg.jp
