旭川信用金庫	www.asahikawa-shinkin.co.jp
網走信用金庫	www.abashin.co.jp
遠軽信用金庫	www.shinkin.co.jp
渡島信用金庫	www.shinkin.co.jp
帯広信用金庫	www.shinkin.co.jp
北空知信用金庫	www.shinkin.co.jp
北見信用金庫	www.shinkin.co.jp
釧路信用金庫	www.shinkin.co.jp
空知信用金庫	www.shinkin.co.jp
大地みらい信用金庫	www.daichimirai.co.jp
伊達信用金庫	dateshin.jp
苫小牧信用金庫	www.tomashin.co.jp
道南うみ街信用金庫	www.d-umishin.co.jp
日高信用金庫	www.shinkin.co.jp
北星信用金庫	www.hokusei-shinkin.co.jp
北門信用金庫	www.shinkin.co.jp
北海道信用金庫	www.shinkin.co.jp
室蘭信用金庫	www.shinkin.co.jp
留萌信用金庫	www.shinkin.co.jp
稚内信用金庫	www.wakashin.co.jp
青い森信用金庫	www.aoimorishinkin.co.jp
東奥信用金庫	www.shinkin.co.jp
一関信用金庫	ichinoseki-shinkin.jp
北上信用金庫	e-shinkin.net
花巻信用金庫	www.shinkin.co.jp
水沢信用金庫	www.mizusawashinkin.co.jp
宮古信用金庫	www.miyashin.jp
盛岡信用金庫	www.morishin.co.jp
石巻信用金庫	www.i-shinkin.co.jp
気仙沼信用金庫	www.shinkin.co.jp
仙南信用金庫	www.shinkin.co.jp
宮城第一信用金庫	www.miyashinbank.co.jp
杜の都信用金庫	www.morinomiyako-shinkin.co.jp
秋田信用金庫	www.shinkin.co.jp
羽後信用金庫	www.ugoshinkin.jp
新庄信用金庫	www.shinjosk.co.jp
鶴岡信用金庫	www.tsuruoka-sk.jp
山形信用金庫	www.y-shinkin.co.jp
米沢信用金庫	www.shinkin.co.jp
会津信用金庫	www.aizu-shinkin.jp
あぶくま信用金庫	www.abukuma.co.jp
郡山信用金庫	gunshin.co.jp
白河信用金庫	www.shirakawa-shinkin.jp
須賀川信用金庫	www.sushin.co.jp
二本松信用金庫	www.shinkin.co.jp
ひまわり信用金庫	www.shinkin.co.jp
福島信用金庫	www.shinkin.co.jp
水戸信用金庫	www.mitoshin.co.jp
結城信用金庫	www.shinkin.co.jp
足利小山信用金庫	www.ashikagaoyamashinkin.co.jp
大田原信用金庫	www.ohtawara-shinkin.co.jp
鹿沼相互信用金庫	www.kashinkin.co.jp
烏山信用金庫	www.karashin-bank.co.jp
佐野信用金庫	www.sanoshin.co.jp
栃木信用金庫	www.shinkin.co.jp
アイオー信用金庫	www.io-web.jp
北群馬信用金庫	www.shinkin.co.jp
桐生信用金庫	www.shinkin.co.jp
しののめ信用金庫	www.shinonome-shinkin.jp
高崎信用金庫	www.takashin-net.co.jp
館林信用金庫	www.shinkin.co.jp
利根郡信用金庫	www.toneshin.co.jp
青木信用金庫	www.shinkin.co.jp
川口信用金庫	www.shinkin.co.jp
埼玉縣信用金庫	www.saishin.co.jp
飯能信用金庫	www.hanno-shinkin.jp
佐原信用金庫	www.shinkin.co.jp
館山信用金庫	www.shinkin.co.jp
千葉信用金庫	www.shinkin.co.jp
銚子信用金庫	www.choshi-shinkin.co.jp
東京ベイ信用金庫	www.bayshin.co.jp
朝日信用金庫	www.asahi-shinkin.co.jp
足立成和信用金庫	www.adachiseiwa.co.jp
青梅信用金庫	www.aosyn.co.jp
亀有信用金庫	www.shinkin.co.jp
興産信用金庫	www.shinkin.co.jp
小松川信用金庫	www.shinkin.co.jp
西京信用金庫	www.shinkin.co.jp
さわやか信用金庫	www.sawayaka-shinkin.co.jp
芝信用金庫	www.shibashin.jp
城南信用金庫	www.jsbank.co.jp
城北信用金庫	www.shinkin.co.jp
昭和信用金庫	www.shinkin.co.jp
巣鴨信用金庫	www.sugamo.co.jp
西武信用金庫	www.shinkin.co.jp
世田谷信用金庫	www.shinkin.co.jp
瀧野川信用金庫	www.takishin.jp
多摩信用金庫	www.tamashin.jp
東榮信用金庫	www.toeishinkin.co.jp
東京信用金庫	www.tokyo-shinkin.co.jp
東京三協信用金庫	www.shinkin.co.jp
東京シティ信用金庫	www.shinkin.co.jp
東京東信用金庫	www.higashin.co.jp
目黒信用金庫	www.shinkin.co.jp
かながわ信用金庫	www.shinkin.co.jp
川崎信用金庫	www.kawashin.co.jp
さがみ信用金庫	www.shinkin.co.jp
湘南信用金庫	www.shinkin.co.jp
中栄信用金庫	www.shinkin.co.jp
中南信用金庫	www.chunan-shinkin.co.jp
平塚信用金庫	www.shinkin.co.jp
横浜信用金庫	www.yokoshin.co.jp
新井信用金庫	www.shinkin.co.jp
柏崎信用金庫	www.ksbank.jp
加茂信用金庫	www.shinkin.co.jp
三条信用金庫	www.shinkin.co.jp
新発田信用金庫	www.shibata-shinkin.co.jp
上越信用金庫	www.joetsu-shinkin.jp
長岡信用金庫	www.nagaoka-shinkin.com
新潟信用金庫	www.niigata-shinkin.co.jp
村上信用金庫	www.murakami-shinkin.com
甲府信用金庫	www.kofushinkin.co.jp
山梨信用金庫	www.yamasin.jp
アルプス中央信用金庫	www.alupuschuo-shinkin.jp
飯田信用金庫	www.iidashinkin.co.jp
上田信用金庫	www.ueda-shinkin.jp
諏訪信用金庫	www.suwashinkin.co.jp
長野信用金庫	www.nagano-shinkin.jp
松本信用金庫	www.matsumoto-shinkin.jp
大垣西濃信用金庫	www.ogakiseino-shinkin.co.jp
岐阜信用金庫	www.gifushin.co.jp
関信用金庫	www.sekishinkin.co.jp
高山信用金庫	www.shinkin.co.jp
東濃信用金庫	www.shinkin.co.jp
八幡信用金庫	www.shinkin.co.jp
遠州信用金庫	www.shinkin.co.jp
しずおか焼津信用金庫	www.shizuokayaizu-shinkin.co.jp
島田掛川信用金庫	www.sk-shinkin.co.jp
静清信用金庫	www.seishin-shinkin.co.jp
沼津信用金庫	www.numashin.co.jp
浜松磐田信用金庫	hamamatsu-iwata.jp
富士信用金庫	fuji-shinkin.jp
富士宮信用金庫	www.miyashin.co.jp
三島信用金庫	www.mishima-shinkin.co.jp
愛知信用金庫	www.aichishinkin.co.jp
いちい信用金庫	www.shinkin.co.jp
岡崎信用金庫	www.okashin.co.jp
蒲郡信用金庫	www.gamashin.co.jp
瀬戸信用金庫	www.setoshin.co.jp
知多信用金庫	www.chitashin.co.jp
中日信用金庫	www.shinkin.co.jp
東春信用金庫	www.toshun.co.jp
豊川信用金庫	www.kawa-shin.co.jp
豊田信用金庫	www.toyoshin.co.jp
豊橋信用金庫	www.toyo-shin.co.jp
西尾信用金庫	www.shinkin.co.jp
半田信用金庫	www.hanshin-ca.co.jp
尾西信用金庫	www.bi-shin.co.jp
碧海信用金庫	www.hekishin.jp
北伊勢上野信用金庫	www.kitaiseueno-shinkin.jp
紀北信用金庫	www.shinkin.co.jp
桑名三重信用金庫	www.shinkin.co.jp
津信用金庫	www.tsushinkin.co.jp
石動信用金庫	www.shinkin.co.jp
新湊信用金庫	www.shinkin.co.jp
高岡信用金庫	www.shinkin.co.jp
砺波信用金庫	www.tonami-shinkin.co.jp
富山信用金庫	www.shinkin.co.jp
にいかわ信用金庫	www.shinkin.co.jp
氷見伏木信用金庫	www.shinkin.co.jp
金沢信用金庫	www.shinkin.co.jp
興能信用金庫	www.kono-shinkin.co.jp
のと共栄信用金庫	www.shinkin.co.jp
はくさん信用金庫	www.hakusanshinkin.co.jp
越前信用金庫	www.shinkin.co.jp
小浜信用金庫	www.shinkin.co.jp
敦賀信用金庫	www.shinkin.co.jp
福井信用金庫	www.shinkin.co.jp
湖東信用金庫	www.kotoshin.co.jp
滋賀中央信用金庫	www.shigachushin.jp
長浜信用金庫	www.nagashin.co.jp
京都信用金庫	www.kyoto-shinkin.co.jp
京都中央信用金庫	www.chushin.co.jp
京都北都信用金庫	www.hokuto-shinkin.co.jp
永和信用金庫	www.eiwa-shinkin.co.jp
大阪信用金庫	www.osaka-shinkin.co.jp
大阪厚生信用金庫	www.co-sei.co.jp
大阪シティ信用金庫	www.osaka-city-shinkin.co.jp
大阪商工信用金庫	www.osaka-shoko.co.jp
北おおさか信用金庫	www.kitaosaka-shinkin.co.jp
枚方信用金庫	www.shinkin.co.jp
尼崎信用金庫	www.amashin.co.jp
淡路信用金庫	www.shinkin.co.jp
神戸信用金庫	www.shinkinbank.co.jp
但馬信用金庫	www.tanshin.co.jp
但陽信用金庫	www.tanyo-shinkin.co.jp
中兵庫信用金庫	www.nakashin.co.jp
西兵庫信用金庫	www.shinkin.co.jp
日新信用金庫	www.nisshin-shinkin.co.jp
播州信用金庫	www.shinkin.co.jp
姫路信用金庫	www.shinkin.co.jp
兵庫信用金庫	www.shinkin.co.jp
奈良信用金庫	www.narashin.co.jp
奈良中央信用金庫	www.narachuo-shinkinbank.co.jp
大和信用金庫	www.yamato-shinkin.co.jp
きのくに信用金庫	www.kinokuni-shinkin.jp
新宮信用金庫	www.shinkin.co.jp
倉吉信用金庫	www.kurashin.co.jp
鳥取信用金庫	www.shinkin.co.jp
米子信用金庫	www.shinkin.co.jp
しまね信用金庫	www.shimane-shinkin.co.jp
島根中央信用金庫	www.shimanechuuou.co.jp
日本海信用金庫	nihonkaishinkin.co.jp
おかやま信用金庫	www.shinkin.co.jp
吉備信用金庫	www.shinkin.co.jp
玉島信用金庫	www.tamashin.co.jp
津山信用金庫	www.shinkin.co.jp
備前日生信用金庫	www.shinkin.co.jp
備北信用金庫	www.shinkin.co.jp
水島信用金庫	www.mizushin.co.jp
呉信用金庫	www.kure-shinkin.jp
しまなみ信用金庫	www.shimanami-shinkin.jp
広島信用金庫	www.hiroshin.co.jp
広島みどり信用金庫	www.shinkin.co.jp
西中国信用金庫	www.nishichugoku.co.jp
萩山口信用金庫	www.shinkin.co.jp
東山口信用金庫	www.higashiyamaguchi-shinkin.co.jp
阿南信用金庫	www.anan-shinkin.jp
徳島信用金庫	www.shinkin.co.jp
観音寺信用金庫	www.kanshin.co.jp
高松信用金庫	www.takashin.co.jp
宇和島信用金庫	www.shinkin.co.jp
愛媛信用金庫	www.shinkin.co.jp
川之江信用金庫	www.kawanoe-shinkin.co.jp
東予信用金庫	www.toyoshinkin.co.jp
高知信用金庫	www.combank.co.jp
幡多信用金庫	www.shinkin.co.jp
飯塚信用金庫	iishin.jp
大川信用金庫	www.shinkin.co.jp
大牟田柳川信用金庫	www.shinkin.co.jp
遠賀信用金庫	www.shinkin.co.jp
田川信用金庫	www.tagawashinkin.co.jp
筑後信用金庫	www.shinkin.co.jp
福岡信用金庫	www.fukuoka-shinkin.co.jp
福岡ひびき信用金庫	www.fukuokahibiki.co.jp
伊万里信用金庫	www.imarishinkin.co.jp
唐津信用金庫	www.karashin.co.jp
九州ひぜん信用金庫	www.qhize.com
佐賀信用金庫	www.sagashin.co.jp
たちばな信用金庫	www.tachibana-shinkin.jp
天草信用金庫	www.shinkin.co.jp
熊本信用金庫	www.kumamoto-shinkin.jp
熊本第一信用金庫	www.daiichishinkin.co.jp
熊本中央信用金庫	www.kumachu.jp
大分信用金庫	www.shinkin.co.jp
大分みらい信用金庫	www.oitamirai.co.jp
日田信用金庫	www.hitashinkin.co.jp
高鍋信用金庫	www.takanabe-shinkin.jp
延岡信用金庫	www.nobeshin.jp
宮崎第一信用金庫	www.miyasin.co.jp
奄美大島信用金庫	www.amamishinkin.co.jp
鹿児島信用金庫	kashin.co.jp
鹿児島相互信用金庫	www.shinkin.co.jp
コザ信用金庫	www.kozashinkin.co.jp
