全国信用協同組合連合会	www.zenshinkumiren.jp
ウリ信用組合	www.urishinkumi.com
釧路信用組合	www.kushiro.shinkumi.jp
札幌中央信用組合	www.sa-chushin.shinkumi.jp
空知商工信用組合	www.sorachi.shinkumi.jp
十勝信用組合	tokachishinkumi.com
函館商工信用組合	www.hakodate.shinkumi.jp
北央信用組合	www.hokuoh.shinkumi.jp
青森県信用組合	www.aomoriken.shinkumi.co.jp
岩手県医師信用組合	www.idcu.shinkumi.jp
杜陵信用組合	www.toryo-shinkumi.jp
石巻商工信用組合	www.ishinomakisyokou.shinkumi.jp
仙北信用組合	www.senpoku.shinkumi.jp
古川信用組合	www.furushin.co.jp
秋田県信用組合	www.akita-kenshin.jp
北郡信用組合	kitagunshinkumi.jp
山形県医師信用組合	www.yama-ishishinkumi.co.jp
山形第一信用組合	www.yamagatadaiichi.com
山形中央信用組合	www.yamachuu-ca.co.jp
会津商工信用組合	www.aizushinkumi.co.jp
いわき信用組合	www.iwaki-shinkumi.com
相双五城信用組合	www.sogo-shinkumi.co.jp
福島県商工信用組合	www.fukushimakenshin.co.jp
茨城県信用組合	www.kenshinbank.co.jp
那須信用組合	www.nasushin.co.jp
真岡信用組合	www.moka.shinkumi.jp
あかぎ信用組合	www.skibank.co.jp
群馬県信用組合	www.kenshinyo.co.jp
群馬県医師信用組合	www.gunmaishi.shinkumi.jp
ぐんまみらい信用組合	www.skibank.co.jp
熊谷商工信用組合	www.kumashin.co.jp
埼玉信用組合	www.saitamashinkumi.co.jp
埼玉県医師信用組合	www.stdb.co.jp
君津信用組合	kimishin.jp
銚子商工信用組合	www.choshi-shoko.co.jp
房総信用組合	www.boshin.jp
朝日新聞信用組合	www.asahishimbun.shinkumi.jp
あすか信用組合	www.asuka-c.jp
東信用組合	www.azuma.shinkumi.jp
共立信用組合	www.kyouritsu.shinkumi.co.jp
警視庁職員信用組合	www.keishintokyo.co.jp
江東信用組合	www.koutou.shinkumi.jp
七島信用組合	www.shichitou.shinkumi.co.jp
青和信用組合	cb-seiwa.co.jp
全東栄信用組合	www.zentouei.shinkumi.jp
第一勧業信用組合	www.daiichikanshin.com
大東京信用組合	www.daisin.co.jp
東京厚生信用組合	www.tokyokosei.co.jp
東京証券信用組合	www.tokyosyoken.shinkumi.jp
東京消防信用組合	www.shoubou.co.jp
東京都職員信用組合	www.toshokushin.co.jp
東浴信用組合	www.touyoku.shinkumi.jp
中ノ郷信用組合	www.nakanogou.shinkumi.co.jp
ハナ信用組合	www.hanashinkumi.com
文化産業信用組合	www.bunka-shinyo.co.jp
小田原第一信用組合	www.daishin.shinkumi.jp
神奈川県医師信用組合	www.ishishin.co.jp
神奈川県歯科医師信用組合	www.shikashin.co.jp
横浜幸銀信用組合	www.yokohamakougin.co.jp
相愛信用組合	www.soaishinkumi.co.jp
信用組合横浜華銀	www.shinyokumiai.or.jp
糸魚川信用組合	itoigawa-shinkumi.co.jp
協栄信用組合	www.kyoei-shinkumi.jp
興栄信用組合	www.kouei.shinkumi.jp
三條信用組合	www.sanjyou.shinkumi.co.jp
ゆきぐに信用組合	www.shiozawa.shinkumi.jp
新潟縣信用組合	www.niigata-kenshin.co.jp
新潟大栄信用組合	www.niigata-daiei.shinkumi.jp
新潟鉄道信用組合	www.nts-40.co.jp
はばたき信用組合	www.habataki-shinkumi.jp
巻信用組合	www.maki.shinkumi.jp
都留信用組合	www.tsurushinkumi.co.jp
山梨県民信用組合	www.yamanashikenmin.shinkumi.jp
長野県信用組合	www.naganokenshin.jp
イオ信用組合	www.io-shin.com
岐阜県医師信用組合	www.gifu.med.or.jp
岐阜商工信用組合	www.shoushin.co.jp
飛騨信用組合	www.hidashin.co.jp
益田信用組合	www.masushin.jp
静岡県医師信用組合	www.shizuokaishin.co.jp
愛知県医師信用組合	www.aichikenishishin.co.jp
愛知県医療信用組合	www.iryoushin.com
愛知県警察信用組合	www.aichikeishin.shinkumi.jp
愛知県中央信用組合	www.aichi-kenshin.co.jp
信用組合愛知商銀	www.a-sg.jp
豊橋商工信用組合	www.toyohashi-shoko.co.jp
名古屋青果物信用組合	www.shinyokumiai.or.jp
丸八信用組合	www.maruhachi-shinkumi.jp
三重県職員信用組合	www.sansyokushin.shinkumi.jp
富山県信用組合	www.toyama-kenshin.co.jp
富山県医師信用組合	www.toyamadcu.co.jp
石川県医師信用組合	www.ishikawaishishin.co.jp
金沢中央信用組合	www.kanazawachuo.shinkumi.jp
福井県医師信用組合	fukui-med-ishin.jp
福泉信用組合	www.fukusen.jp
滋賀県信用組合	www.shigaken.shinkumi.jp
滋賀県民信用組合	www.shigakenmin.shinkumi.jp
京滋信用組合	www.keiji-shinkumi.net
大阪協栄信用組合	osaka-kyoei.co.jp
大阪貯蓄信用組合	osakachochiku.co.jp
大阪府医師信用組合	www.odcu.co.jp
大阪府警察信用組合	osaka-keishin.co.jp
近畿産業信用組合	www.kinsan.co.jp
成協信用組合	www.seikyo-shinkumi.jp
大同信用組合	www.daido.shinkumi.jp
中央信用組合	www.shinyokumiai.or.jp
のぞみ信用組合	www.nozomi.shinkumi.jp
毎日信用組合	www.mainichi-shinkumi.com
ミレ信用組合	www.mire.co.jp
神戸市職員信用組合	www.kobe-syokusin.shinkumi.jp
淡陽信用組合	www.danyo.co.jp
兵庫県信用組合	www.hyogokenshin.co.jp
兵庫県医療信用組合	www.hyoishin.co.jp
兵庫県警察信用組合	www.hyogo-keishin.co.jp
兵庫ひまわり信用組合	www.h-himawari.com
和歌山県医師信用組合	www.wakayamaishishin.co.jp
島根益田信用組合	www.shimane-masushin.co.jp
笠岡信用組合	www.kasaoka.shinkumi.jp
朝銀西信用組合	www.chogin-nishi.com
呉市職員信用組合	www.shinyokumiai.or.jp
広島県信用組合	www.hiroshima-kenshin.co.jp
広島市信用組合	www.hiroshimashi.shinkumi.jp
信用組合広島商銀	www.shogin.com
備後信用組合	www.binshin.co.jp
両備信用組合	www.ryobishinkumi.co.jp
山口県信用組合	www.yamaguchiken.shinkumi.jp
香川県信用組合	www.kagawaken.shinkumi.jp
宿毛商銀信用組合	sukumo-shogin.co.jp
土佐信用組合	www.tosa.shinkumi.jp
福岡県医師信用組合	www.shinyokumiai.or.jp
福岡県信用組合	www.kenshin-f.jp
福岡県庁信用組合	www.shinyokumiai.or.jp
佐賀県医師信用組合	www.shinyokumiai.or.jp
佐賀西信用組合	www.saganishi.shinkumi.jp
佐賀東信用組合	www.toshin.shinkumi.jp
西海みずき信用組合	saikaimizuki.co.jp
長崎県医師信用組合	www.nagasaki-ishishin.jp
長崎三菱信用組合	www.ryo-sin.co.jp
福江信用組合	www.fukue-cb.jp
熊本県信用組合	www.kumamotoken.shinkumi.jp
熊本県医師信用組合	www.kumamoto.med.or.jp
大分県信用組合	www.oita-kenshin.co.jp
宮崎県南部信用組合	www.m-nanbu.shinkumi.jp
奄美信用組合	www.amamishinkumi.co.jp
鹿児島県医師信用組合	www.kagoshima.med.or.jp
鹿児島興業信用組合	www.ka-kousin.co.jp
