北海道銀行	www.hokkaidobank.co.jp
青森銀行	www.a-bank.jp
みちのく銀行	www.michinokubank.co.jp
岩手銀行	www.iwatebank.co.jp
東北銀行	www.tohoku-bank.co.jp
七十七銀行	www.77bank.co.jp
秋田銀行	www.akita-bank.co.jp
北都銀行	www.hokutobank.co.jp
荘内銀行	www.shonai.co.jp
山形銀行	www.yamagatabank.co.jp
東邦銀行	www.tohobank.co.jp
常陽銀行	www.joyobank.co.jp
筑波銀行	www.tsukubabank.co.jp
足利銀行	www.ashikagabank.co.jp
群馬銀行	www.gunmabank.co.jp
武蔵野銀行	www.musashinobank.co.jp
千葉銀行	www.chibabank.co.jp
千葉興業銀行	www.chibakogyo-bank.co.jp
きらぼし銀行	www.kiraboshibank.co.jp
横浜銀行	www.boy.co.jp
第四北越銀行	www.dhbk.co.jp
山梨中央銀行	www.yamanashibank.co.jp
八十二銀行	www.82bank.co.jp
大垣共立銀行	www.okb.co.jp
十六銀行	www.juroku.co.jp
静岡銀行	www.shizuokabank.co.jp
スルガ銀行	www.surugabank.co.jp
清水銀行	www.shimizubank.co.jp
百五銀行	www.hyakugo.co.jp
三十三銀行	www.33bank.co.jp
北陸銀行	www.hokugin.co.jp
富山銀行	www.toyamabank.co.jp
北國銀行	www.hokkokubank.co.jp
福井銀行	www.fukuibank.co.jp
滋賀銀行	www.shigagin.com
京都銀行	www.kyotobank.co.jp
関西みらい銀行	www.kansaimiraibank.co.jp
池田泉州銀行	www.sihd-bk.jp
但馬銀行	www.tajimabank.co.jp
南都銀行	www.nantobank.co.jp
紀陽銀行	www.kiyobank.co.jp
鳥取銀行	www.tottoribank.co.jp
山陰合同銀行	www.gogin.co.jp
中国銀行	www.chugin.co.jp
広島銀行	www.hirogin.co.jp
山口銀行	www.yamaguchibank.co.jp
阿波銀行	www.awabank.co.jp
百十四銀行	www.114bank.co.jp
伊予銀行	www.iyobank.co.jp
四国銀行	www.shikokubank.co.jp
福岡銀行	www.fukuokabank.co.jp
筑邦銀行	www.chikugin.co.jp
西日本シティ銀行	www.ncbank.co.jp
北九州銀行	www.kitakyushubank.co.jp
佐賀銀行	www.sagabank.co.jp
十八親和銀行	www.18shinwabank.co.jp
肥後銀行	www.higobank.co.jp
大分銀行	www.oitabank.co.jp
宮崎銀行	www.miyagin.co.jp
鹿児島銀行	www.kagin.co.jp
琉球銀行	www.ryugin.co.jp
沖縄銀行	www.okinawa-bank.co.jp
