あいおいニッセイ同和損害保険	www.aioinissaydowa.co.jp
アイペット損害保険	www.ipet-ins.com
アクサ損害保険	www.axa-direct.co.jp
アニコム損害保険	www.anicom-sompo.co.jp
アメリカンホーム医療・損害保険	www.americanhome.co.jp
アリアンツ火災海上保険	www.allianz.co.jp
イーデザイン損害保険	www.edsp.co.jp
AIG損害保険	www.aig.co.jp
au損害保険	www.au-sonpo.co.jp
エイチ・エス損害保険	www.hs-sonpo.co.jp
SBI損害保険	www.sbisonpo.co.jp
カーディフ損害保険	nonlife.cardif.co.jp
共栄火災海上保険	www.kyoeikasai.co.jp
さくら損害保険	www.sakura-ins.co.jp
ジェイアイ傷害火災保険	www.jihoken.co.jp
セコム損害保険	www.secom-sonpo.co.jp
セゾン自動車火災保険	www.ins-saison.co.jp
全管協れいわ損害保険	www.zkreiwa-sonpo.co.jp
ソニー損害保険	www.sonysonpo.co.jp
損害保険ジャパン	www.sompo-japan.co.jp
大同火災海上保険	www.daidokasai.co.jp
Chubb損害保険	www.chubb.com
東京海上日動火災保険	www.tokiomarine-nichido.co.jp
トーア再保険	www.toare.co.jp
日新火災海上保険	www.nisshinfire.co.jp
日本地震再保険	www.nihonjishin.co.jp
キャピタル損害保険	www.capital-sonpo.co.jp
ペット&ファミリー損害保険	www.petfamilyins.co.jp
三井住友海上火災保険	www.ms-ins.com
三井ダイレクト損害保険	www.mitsui-direct.co.jp
明治安田損害保険	www.meijiyasuda-sonpo.co.jp
楽天損害保険	www.rakuten-sonpo.co.jp
レスキュー損害保険	www.rescue-sonpo.jp
