アクサ生命保険	www.axa.co.jp
アクサダイレクト生命保険	www.axa-direct-life.co.jp
朝日生命保険	www.asahi-life.co.jp
アフラック生命保険	www.aflac.co.jp
イオン・アリアンツ生命保険	www.aeon-allianz.co.jp
SBI生命保険	www.sbilife.co.jp
エヌエヌ生命保険	www.nnlife.co.jp
FWD富士生命保険	www.fwdfujilife.co.jp
オリックス生命保険	www.orixlife.co.jp
カーディフ生命保険	life.cardif.co.jp
かんぽ生命保険	www.jp-life.japanpost.jp
クレディ・アグリコル生命保険	www.ca-life.jp
ジブラルタ生命保険	www.gib-life.co.jp
住友生命保険	www.sumitomolife.co.jp
ソニー生命保険	www.sonylife.co.jp
SOMPOひまわり生命保険	www.himawari-life.co.jp
第一生命保険	www.dai-ichi-life.co.jp
第一フロンティア生命保険	www.d-frontier-life.co.jp
大樹生命保険	www.taiju-life.co.jp
大同生命保険	www.daido-life.co.jp
太陽生命保険	www.taiyo-seimei.co.jp
チューリッヒ生命保険	www.zurichlife.co.jp
T&Dフィナンシャル生命保険	www.tdf-life.co.jp
東京海上日動あんしん生命保険	www.tmn-anshin.co.jp
なないろ生命保険	www.nanairolife.co.jp
ニッセイ・ウェルス生命保険	www.nw-life.co.jp
日本生命保険	www.nissay.co.jp
ネオファースト生命保険	neofirst.co.jp
はなさく生命保険	www.life8739.co.jp
フコクしんらい生命保険	www.fukokushinrai.co.jp
富国生命保険	www.fukoku-life.co.jp
プルデンシャルジブラルタファイナンシャル生命保険	www.pgf-life.co.jp
プルデンシャル生命保険	www.prudential.co.jp
マニュライフ生命保険	www.manulife.co.jp
三井住友海上あいおい生命保険	www.msa-life.co.jp
三井住友海上プライマリー生命保険	www.ms-primary.com
みどり生命保険	midori-life.com
明治安田生命保険	www.meijiyasuda.co.jp
メットライフ生命保険	www.metlife.co.jp
メディケア生命保険	www.medicarelife.com
ライフネット生命保険	www.lifenet-seimei.co.jp
楽天生命保険	www.rakuten-life.co.jp