北洋銀行	www.hokuyobank.co.jp
北日本銀行	www.kitagin.co.jp
仙台銀行	www.sendaibank.co.jp
きらやか銀行	www.kirayaka.co.jp
福島銀行	www.fukushimabank.co.jp
大東銀行	www.daitobank.co.jp
栃木銀行	www.tochigibank.co.jp
東和銀行	www.towabank.co.jp
京葉銀行	www.keiyobank.co.jp
東日本銀行	www.higashi-nipponbank.co.jp
東京スター銀行	www.tokyostarbank.co.jp
神奈川銀行	www.kanagawabank.co.jp
大光銀行	www.taikobank.jp
長野銀行	www.naganobank.co.jp
静岡中央銀行	www.shizuokachuo-bank.co.jp
愛知銀行	www.aichibank.co.jp
名古屋銀行	www.meigin.com
中京銀行	www.chukyo-bank.co.jp
富山第一銀行	www.first-bank.co.jp
福邦銀行	www.fukuho.co.jp
みなと銀行	www.minatobk.co.jp
島根銀行	www.shimagin.co.jp
トマト銀行	www.tomatobank.co.jp
もみじ銀行	www.momijibank.co.jp
西京銀行	www.saikyobank.co.jp
徳島大正銀行	www.tokugin.co.jp
香川銀行	www.kagawabank.co.jp
愛媛銀行	www.himegin.co.jp
高知銀行	www.kochi-bank.co.jp
福岡中央銀行	www.fukuokachuo-bank.co.jp
佐賀共栄銀行	www.kyogin.co.jp
長崎銀行	www.nagasakibank.co.jp
熊本銀行	www.kumamotobank.co.jp
豊和銀行	www.howabank.co.jp
宮崎太陽銀行	www.taiyobank.co.jp
南日本銀行	nangin.jp
沖縄海邦銀行	www.kaiho-bank.co.jp
