みずほフィナンシャルグループ	www.mizuho-fg.co.jp
三井住友フィナンシャルグループ	www.smfg.co.jp
三菱UFJフィナンシャル・グループ	www.mufg.jp
りそなホールディングス	www.resona-gr.co.jp
ソニーフィナンシャルホールディングス	www.sonyfh.co.jp
三井住友トラスト・ホールディングス	www.smth.jp
日本郵政	www.japanpost.jp
AFSコーポレーション	www.afscorporation.co.jp
auフィナンシャルホールディングス	www.au-financial.com
フィデアホールディングス	www.fidea.co.jp
じもとホールディングス	www.jimoto-hd.co.jp
第四北越フィナンシャルグループ	www.dhfg.co.jp
めぶきフィナンシャルグループ	www.mebuki-fg.co.jp
東京きらぼしフィナンシャルグループ	www.tokyo-kiraboshifg.co.jp
コンコルディア・フィナンシャルグループ	www.concordia-fg.jp
三十三フィナンシャルグループ	www.33fg.co.jp
十六フィナンシャルグループ	www.16fg.co.jp
ほくほくフィナンシャルグループ	www.hokuhoku-fg.co.jp
北國フィナンシャルホールディングス	www.hokkokubank.co.jp
池田泉州ホールディングス	www.senshuikeda-hd.co.jp
関西みらいフィナンシャルグループ	www.kmfg.co.jp
山口フィナンシャルグループ	www.ymfg.co.jp
ひろぎんホールディングス	www.hirogin-hd.co.jp
トモニホールディングス	www.tomony-hd.co.jp
ふくおかフィナンシャルグループ	www.fukuoka-fg.com
西日本フィナンシャルホールディングス	www.nnfh.co.jp
九州フィナンシャルグループ	www.kyushu-fg.co.jp
おきなわフィナンシャルグループ	www.okinawafg.co.jp