札幌市	city.sapporo.jp
函館市	city.hakodate.hokkaido.jp
小樽市	city.otaru.hokkaido.jp
旭川市	city.asahikawa.hokkaido.jp
室蘭市	city.muroran.hokkaido.jp
釧路市	city.kushiro.hokkaido.jp
帯広市	city.obihiro.hokkaido.jp
北見市	city.kitami.hokkaido.jp
#夕張市	city.yuubari.hokkaido.jp
岩見沢市	city.iwamizawa.hokkaido.jp
網走市	city.abashiri.hokkaido.jp
#留萌市	city.rumoi.hokkaido.jp
苫小牧市	city.tomakomai.hokkaido.jp
稚内市	city.wakkanai.hokkaido.jp
美唄市	city.bibai.hokkaido.jp
芦別市	city.ashibetsu.hokkaido.jp
江別市	city.ebetsu.hokkaido.jp
赤平市	city.akabira.hokkaido.jp
#紋別市	city.mombetsu.hokkaido.jp
#士別市	city.shibetsu.hokkaido.jp
名寄市	city.nayoro.hokkaido.jp
三笠市	city.mikasa.hokkaido.jp
根室市	city.nemuro.hokkaido.jp
千歳市	city.chitose.hokkaido.jp
滝川市	city.takikawa.hokkaido.jp
砂川市	city.sunagawa.hokkaido.jp
歌志内市	city.utashinai.hokkaido.jp
深川市	city.fukagawa.hokkaido.jp
富良野市	city.furano.hokkaido.jp
登別市	city.noboribetsu.hokkaido.jp
恵庭市	city.eniwa.hokkaido.jp
伊達市	city.date.hokkaido.jp
北広島市	city.kitahiroshima.hokkaido.jp
石狩市	city.ishikari.hokkaido.jp
北斗市	city.hokuto.hokkaido.jp
当別町	town.tobetsu.hokkaido.jp
新篠津村	vill.shinshinotsu.hokkaido.jp
松前町	town.matsumae.hokkaido.jp
福島町	town.fukushima.hokkaido.jp
知内町	town.shiriuchi.hokkaido.jp
木古内町	town.kikonai.hokkaido.jp
七飯町	town.nanae.hokkaido.jp
鹿部町	town.shikabe.hokkaido.jp
#森町	town.mori.hokkaido.jp
八雲町	town.yakumo.hokkaido.jp
#長万部町	town.oshamambe.hokkaido.jp
江差町	town.esashi.hokkaido.jp
#上ノ国町	town.kaminokuni.hokkaido.jp
厚沢部町	town.assabu.hokkaido.jp
#乙部町	town.otobe.hokkaido.jp
#奥尻町	town.okushiri.hokkaido.jp
今金町	town.imakane.hokkaido.jp
#せたな町	town.setana.hokkaido.jp
#島牧村	vill.shimamaki.hokkaido.jp
#寿都町	town.suttsu.hokkaido.jp
黒松内町	town.kuromatsunai.hokkaido.jp
蘭越町	town.rankoshi.hokkaido.jp
#ニセコ町	town.niseko.hokkaido.jp
#真狩村	vill.makkari.hokkaido.jp
#留寿都村	vill.rusutsu.hokkaido.jp
喜茂別町	town.kimobetsu.hokkaido.jp
#京極町	town.kyogoku.hokkaido.jp
倶知安町	town.kutchan.hokkaido.jp
共和町	town.kyowa.hokkaido.jp
岩内町	town.iwanai.hokkaido.jp
泊村	vill.tomari.hokkaido.jp
神恵内村	vill.kamoenai.hokkaido.jp
積丹町	town.shakotan.hokkaido.jp
#古平町	town.furubira.hokkaido.jp
仁木町	town.niki.hokkaido.jp
余市町	town.yoichi.hokkaido.jp
#赤井川村	vill.akaigawa.hokkaido.jp
#南幌町	town.namporo.hokkaido.jp
奈井江町	town.naie.hokkaido.jp
上砂川町	town.kamisunagawa.hokkaido.jp
#由仁町	town.yuni.hokkaido.jp
#長沼町	town.naganuma.hokkaido.jp
栗山町	town.kuriyama.hokkaido.jp
月形町	town.tsukigata.hokkaido.jp
浦臼町	town.urausu.hokkaido.jp
#新十津川町	town.shintotsukawa.hokkaido.jp
妹背牛町	town.moseushi.hokkaido.jp
秩父別町	town.chippubetsu.hokkaido.jp
雨竜町	town.uryu.hokkaido.jp
北竜町	town.hokuryu.hokkaido.jp
沼田町	town.numata.hokkaido.jp
鷹栖町	town.takasu.hokkaido.jp
東神楽町	town.higashikagura.hokkaido.jp
#当麻町	town.toma.hokkaido.jp
比布町	town.pippu.hokkaido.jp
愛別町	town.aibetsu.hokkaido.jp
上川町	town.kamikawa.hokkaido.jp
東川町	town.higashikawa.hokkaido.jp
美瑛町	town.biei.hokkaido.jp
上富良野町	town.kamifurano.hokkaido.jp
#中富良野町	town.nakafurano.hokkaido.jp
南富良野町	town.minamifurano.hokkaido.jp
#占冠村	vill.shimukappu.hokkaido.jp
和寒町	town.wassamu.hokkaido.jp
剣淵町	town.kembuchi.hokkaido.jp
下川町	town.shimokawa.hokkaido.jp
美深町	town.bifuka.hokkaido.jp
音威子府村	vill.otoineppu.hokkaido.jp
中川町	town.nakagawa.hokkaido.jp
幌加内町	town.horokanai.hokkaido.jp
増毛町	town.mashike.hokkaido.jp
小平町	town.obira.hokkaido.jp
#苫前町	town.tomamae.hokkaido.jp
羽幌町	town.haboro.hokkaido.jp
#初山別村	vill.shosambetsu.hokkaido.jp
遠別町	town.embetsu.hokkaido.jp
#天塩町	town.teshio.hokkaido.jp
猿払村	vill.sarufutsu.hokkaido.jp
#浜頓別町	town.hamatombetsu.hokkaido.jp
中頓別町	town.nakatombetsu.hokkaido.jp
枝幸町	town.esashi.hokkaido.jp
豊富町	town.toyotomi.hokkaido.jp
礼文町	town.rebun.hokkaido.jp
利尻町	town.rishiri.hokkaido.jp
利尻富士町	town.rishirifuji.hokkaido.jp
幌延町	town.horonobe.hokkaido.jp
美幌町	town.bihoro.hokkaido.jp
津別町	town.tsubetsu.hokkaido.jp
斜里町	town.shari.hokkaido.jp
清里町	town.kiyosato.hokkaido.jp
小清水町	town.koshimizu.hokkaido.jp
訓子府町	town.kunneppu.hokkaido.jp
置戸町	town.oketo.hokkaido.jp
佐呂間町	town.saroma.hokkaido.jp
#遠軽町	town.engaru.hokkaido.jp
#湧別町	town.yuubetsu.hokkaido.jp
#滝上町	town.takinoe.hokkaido.jp
#興部町	town.okoppe.hokkaido.jp
西興部村	vill.nishiokoppe.hokkaido.jp
#雄武町	town.omu.hokkaido.jp
#大空町	town.oozora.hokkaido.jp
#豊浦町	town.toyora.hokkaido.jp
壮瞥町	town.sobetsu.hokkaido.jp
白老町	town.shiraoi.hokkaido.jp
#厚真町	town.atsuma.hokkaido.jp
洞爺湖町	town.toyako.hokkaido.jp
安平町	town.abira.hokkaido.jp
#むかわ町	town.mukawa.hokkaido.jp
日高町	town.hidaka.hokkaido.jp
平取町	town.biratori.hokkaido.jp
#新冠町	town.niikappu.hokkaido.jp
浦河町	town.urakawa.hokkaido.jp
#様似町	town.samani.hokkaido.jp
#えりも町	town.erimo.hokkaido.jp
#新ひだか町	town.shinhidaka.hokkaido.jp
音更町	town.otofuke.hokkaido.jp
#士幌町	town.shihoro.hokkaido.jp
上士幌町	town.kamishihoro.hokkaido.jp
鹿追町	town.shikaoi.hokkaido.jp
新得町	town.shintoku.hokkaido.jp
清水町	town.shimizu.hokkaido.jp
#芽室町	town.memuro.hokkaido.jp
中札内村	vill.nakasatsunai.hokkaido.jp
#更別村	vill.sarabetsu.hokkaido.jp
大樹町	town.taiki.hokkaido.jp
広尾町	town.hiroo.hokkaido.jp
#幕別町	town.makubetsu.hokkaido.jp
池田町	town.ikeda.hokkaido.jp
#豊頃町	town.toyokoro.hokkaido.jp
#本別町	town.hombetsu.hokkaido.jp
足寄町	town.ashoro.hokkaido.jp
#陸別町	town.rikubetsu.hokkaido.jp
#浦幌町	town.urahoro.hokkaido.jp
釧路町	town.kushiro.hokkaido.jp
厚岸町	town.akkeshi.hokkaido.jp
#浜中町	town.hamanaka.hokkaido.jp
標茶町	town.shibecha.hokkaido.jp
弟子屈町	town.teshikaga.hokkaido.jp
#鶴居村	vill.tsurui.hokkaido.jp
白糠町	town.shiranuka.hokkaido.jp
#別海町	town.betsukai.hokkaido.jp
#中標津町	town.nakashibetsu.hokkaido.jp
#標津町	town.shibetsu.hokkaido.jp
#羅臼町	town.rausu.hokkaido.jp
#色丹村	vill.shikotan.hokkaido.jp
泊村	vill.tomari.hokkaido.jp
#留夜別村	vill.ruyabetsu.hokkaido.jp
#留別村	vill.rubetsu.hokkaido.jp
#紗那村	vill.shana.hokkaido.jp
#蘂取村	vill.shibetoro.hokkaido.jp
