さいたま市	city.saitama.jp
川越市	city.kawagoe.saitama.jp
#熊谷市	city.kumagaya.saitama.jp
川口市	city.kawaguchi.saitama.jp
#行田市	city.giyoda.saitama.jp
#秩父市	city.chichibu.saitama.jp
所沢市	city.tokorozawa.saitama.jp
飯能市	city.hanno.saitama.jp
加須市	city.kazo.saitama.jp
#本庄市	city.honjiyo.saitama.jp
#東松山市	city.higashimatsuyama.saitama.jp
#春日部市	city.kasukabe.saitama.jp
狭山市	city.sayama.saitama.jp
羽生市	city.hanyu.saitama.jp
鴻巣市	city.kounosu.saitama.jp
深谷市	city.fukaya.saitama.jp
#上尾市	city.ageo.saitama.jp
草加市	city.soka.saitama.jp
越谷市	city.koshigaya.saitama.jp
蕨市	city.warabi.saitama.jp
戸田市	city.toda.saitama.jp
入間市	city.iruma.saitama.jp
朝霞市	city.asaka.saitama.jp
志木市	city.shiki.saitama.jp
#和光市	city.wako.saitama.jp
#新座市	city.niiza.saitama.jp
#桶川市	city.okegawa.saitama.jp
久喜市	city.kuki.saitama.jp
北本市	city.kitamoto.saitama.jp
八潮市	city.yashio.saitama.jp
富士見市	city.fujimi.saitama.jp
三郷市	city.misato.saitama.jp
蓮田市	city.hasuda.saitama.jp
#坂戸市	city.sakado.saitama.jp
幸手市	city.satte.saitama.jp
鶴ヶ島市	city.tsurugashima.saitama.jp
日高市	city.hidaka.saitama.jp
吉川市	city.yoshikawa.saitama.jp
ふじみ野市	city.fujimino.saitama.jp
#白岡市	city.shiraoka.saitama.jp
伊奈町	town.ina.saitama.jp
三芳町	town.miyoshi.saitama.jp
毛呂山町	town.moroyama.saitama.jp
越生町	town.ogose.saitama.jp
滑川町	town.namegawa.saitama.jp
嵐山町	town.ranzan.saitama.jp
小川町	town.ogawa.saitama.jp
川島町	town.kawajima.saitama.jp
吉見町	town.yoshimi.saitama.jp
鳩山町	town.hatoyama.saitama.jp
#ときがわ町	town.tokigawa.saitama.jp
横瀬町	town.yokoze.saitama.jp
皆野町	town.minano.saitama.jp
長瀞町	town.nagatoro.saitama.jp
#小鹿野町	town.ogano.saitama.jp
東秩父村	vill.higashichichibu.saitama.jp
#美里町	town.misato.saitama.jp
神川町	town.kamikawa.saitama.jp
上里町	town.kamisato.saitama.jp
寄居町	town.yorii.saitama.jp
宮代町	town.miyashiro.saitama.jp
杉戸町	town.sugito.saitama.jp
松伏町	town.matsubushi.saitama.jp
