千葉市	city.chiba.jp
銚子市	city.choshi.chiba.jp
市川市	city.ichikawa.chiba.jp
船橋市	city.funabashi.chiba.jp
館山市	city.tateyama.chiba.jp
木更津市	city.kisarazu.chiba.jp
松戸市	city.matsudo.chiba.jp
野田市	city.noda.chiba.jp
茂原市	city.mobara.chiba.jp
成田市	city.narita.chiba.jp
佐倉市	city.sakura.chiba.jp
東金市	city.togane.chiba.jp
旭市	city.asahi.chiba.jp
習志野市	city.narashino.chiba.jp
柏市	city.kashiwa.chiba.jp
勝浦市	city.katsuura.chiba.jp
市原市	city.ichihara.chiba.jp
流山市	city.nagareyama.chiba.jp
八千代市	city.yachiyo.chiba.jp
我孫子市	city.abiko.chiba.jp
鴨川市	city.kamogawa.chiba.jp
鎌ケ谷市	city.kamagaya.chiba.jp
君津市	city.kimitsu.chiba.jp
富津市	city.futtsu.chiba.jp
浦安市	city.urayasu.chiba.jp
四街道市	city.yotsukaido.chiba.jp
袖ケ浦市	city.sodegaura.chiba.jp
八街市	city.yachimata.chiba.jp
印西市	city.inzai.chiba.jp
白井市	city.shiroi.chiba.jp
富里市	city.tomisato.chiba.jp
南房総市	city.minamiboso.chiba.jp
#匝瑳市	city.sosa.chiba.jp
#香取市	city.katori.chiba.jp
#山武市	city.sammu.chiba.jp
いすみ市	city.isumi.chiba.jp
#大網白里市	city.ooamishirasato.chiba.jp
酒々井町	town.shisui.chiba.jp
栄町	town.sakae.chiba.jp
神崎町	town.kozaki.chiba.jp
多古町	town.tako.chiba.jp
#東庄町	town.tonosho.chiba.jp
九十九里町	town.kujukuri.chiba.jp
#芝山町	town.shibayama.chiba.jp
横芝光町	town.yokoshibahikari.chiba.jp
一宮町	town.ichinomiya.chiba.jp
睦沢町	town.mutsuzawa.chiba.jp
長生村	vill.chosei.chiba.jp
白子町	town.shirako.chiba.jp
長柄町	town.nagara.chiba.jp
長南町	town.chonan.chiba.jp
大多喜町	town.otaki.chiba.jp
御宿町	town.onjuku.chiba.jp
#鋸南町	town.kiyonan.chiba.jp
