津市	city.tsu.mie.jp
四日市市	city.yokkaichi.mie.jp
伊勢市	city.ise.mie.jp
松阪市	city.matsusaka.mie.jp
桑名市	city.kuwana.mie.jp
鈴鹿市	city.suzuka.mie.jp
名張市	city.nabari.mie.jp
#尾鷲市	city.owase.mie.jp
亀山市	city.kameyama.mie.jp
鳥羽市	city.toba.mie.jp
熊野市	city.kumano.mie.jp
いなべ市	city.inabe.mie.jp
志摩市	city.shima.mie.jp
#伊賀市	city.iga.mie.jp
木曽岬町	town.kisosaki.mie.jp
#東員町	town.toin.mie.jp
菰野町	town.komono.mie.jp
朝日町	town.asahi.mie.jp
川越町	town.kawagoe.mie.jp
多気町	town.taki.mie.jp
明和町	town.meiwa.mie.jp
#大台町	town.oodai.mie.jp
玉城町	town.tamaki.mie.jp
度会町	town.watarai.mie.jp
大紀町	town.taiki.mie.jp
南伊勢町	town.minamiise.mie.jp
#紀北町	town.kihoku.mie.jp
御浜町	town.mihama.mie.jp
紀宝町	town.kiho.mie.jp
