岡山市	city.okayama.jp
倉敷市	city.kurashiki.okayama.jp
津山市	city.tsuyama.okayama.jp
玉野市	city.tamano.okayama.jp
笠岡市	city.kasaoka.okayama.jp
井原市	city.ibara.okayama.jp
総社市	city.soja.okayama.jp
高梁市	city.takahashi.okayama.jp
新見市	city.niimi.okayama.jp
備前市	city.bizen.okayama.jp
瀬戸内市	city.setouchi.okayama.jp
赤磐市	city.akaiwa.okayama.jp
真庭市	city.maniwa.okayama.jp
#美作市	city.mimasaka.okayama.jp
浅口市	city.asakuchi.okayama.jp
和気町	town.wake.okayama.jp
早島町	town.hayashima.okayama.jp
里庄町	town.satosho.okayama.jp
矢掛町	town.yakage.okayama.jp
新庄村	vill.shinjo.okayama.jp
鏡野町	town.kagamino.okayama.jp
勝央町	town.shoo.okayama.jp
奈義町	town.nagi.okayama.jp
西粟倉村	vill.nishiawakura.okayama.jp
久米南町	town.kumenan.okayama.jp
美咲町	town.misaki.okayama.jp
吉備中央町	town.kibichuo.okayama.jp
