松山市	city.matsuyama.ehime.jp
今治市	city.imabari.ehime.jp
宇和島市	city.uwajima.ehime.jp
八幡浜市	city.yawatahama.ehime.jp
新居浜市	city.niihama.ehime.jp
西条市	city.saijo.ehime.jp
#大洲市	city.oozu.ehime.jp
伊予市	city.iyo.ehime.jp
四国中央市	city.shikokuchuo.ehime.jp
西予市	city.seiyo.ehime.jp
東温市	city.toon.ehime.jp
上島町	town.kamijima.ehime.jp
#久万高原町	town.kumakogen.ehime.jp
松前町	town.masaki.ehime.jp
砥部町	town.tobe.ehime.jp
内子町	town.uchiko.ehime.jp
伊方町	town.ikata.ehime.jp
松野町	town.matsuno.ehime.jp
鬼北町	town.kihoku.ehime.jp
愛南町	town.ainan.ehime.jp
