高知市	city.kochi.kochi.jp
室戸市	city.muroto.kochi.jp
安芸市	city.aki.kochi.jp
#南国市	city.nankoku.kochi.jp
#土佐市	city.tosa.kochi.jp
#須崎市	city.susaki.kochi.jp
宿毛市	city.sukumo.kochi.jp
土佐清水市	city.tosashimizu.kochi.jp
#四万十市	city.shimanto.kochi.jp
#香南市	city.konan.kochi.jp
香美市	city.kami.kochi.jp
東洋町	town.toyo.kochi.jp
奈半利町	town.nahari.kochi.jp
#田野町	town.tano.kochi.jp
安田町	town.yasuda.kochi.jp
北川村	vill.kitagawa.kochi.jp
馬路村	vill.umaji.kochi.jp
芸西村	vill.geisei.kochi.jp
本山町	town.motoyama.kochi.jp
大豊町	town.otoyo.kochi.jp
土佐町	town.tosa.kochi.jp
大川村	vill.okawa.kochi.jp
いの町	town.ino.kochi.jp
仁淀川町	town.niyodogawa.kochi.jp
#中土佐町	town.nakatosa.kochi.jp
#佐川町	town.sakawa.kochi.jp
越知町	town.ochi.kochi.jp
梼原町	town.yusuhara.kochi.jp
日高村	vill.hidaka.kochi.jp
#津野町	town.tsuno.kochi.jp
#四万十町	town.shimanto.kochi.jp
大月町	town.otsuki.kochi.jp
三原村	vill.mihara.kochi.jp
#黒潮町	town.kuroshio.kochi.jp
