北九州市	city.kitakyushu.jp
福岡市	city.fukuoka.jp
#大牟田市	city.oomuta.fukuoka.jp
久留米市	city.kurume.fukuoka.jp
#直方市	city.noogata.fukuoka.jp
#飯塚市	city.iizuka.fukuoka.jp
田川市	city.tagawa.fukuoka.jp
柳川市	city.yanagawa.fukuoka.jp
八女市	city.yame.fukuoka.jp
#筑後市	city.chikugo.fukuoka.jp
#大川市	city.ookawa.fukuoka.jp
行橋市	city.yukuhashi.fukuoka.jp
#豊前市	city.buzen.fukuoka.jp
#中間市	city.nakama.fukuoka.jp
#小郡市	city.ogoori.fukuoka.jp
筑紫野市	city.chikushino.fukuoka.jp
春日市	city.kasuga.fukuoka.jp
#大野城市	city.oonojo.fukuoka.jp
宗像市	city.munakata.fukuoka.jp
太宰府市	city.dazaifu.fukuoka.jp
古賀市	city.koga.fukuoka.jp
#福津市	city.fukutsu.fukuoka.jp
うきは市	city.ukiha.fukuoka.jp
宮若市	city.miyawaka.fukuoka.jp
#嘉麻市	city.kama.fukuoka.jp
#朝倉市	city.asakura.fukuoka.jp
#みやま市	city.miyama.fukuoka.jp
#糸島市	city.itoshima.fukuoka.jp
#那珂川市	city.nakagawa.fukuoka.jp
宇美町	town.umi.fukuoka.jp
篠栗町	town.sasaguri.fukuoka.jp
#志免町	town.shime.fukuoka.jp
須恵町	town.sue.fukuoka.jp
#新宮町	town.shinguu.fukuoka.jp
久山町	town.hisayama.fukuoka.jp
粕屋町	town.kasuya.fukuoka.jp
芦屋町	town.ashiya.fukuoka.jp
#水巻町	town.mizumaki.fukuoka.jp
#岡垣町	town.okagaki.fukuoka.jp
遠賀町	town.onga.fukuoka.jp
#小竹町	town.kotake.fukuoka.jp
#鞍手町	town.kurate.fukuoka.jp
桂川町	town.keisen.fukuoka.jp
筑前町	town.chikuzen.fukuoka.jp
東峰村	vill.toho.fukuoka.jp
大刀洗町	town.tachiarai.fukuoka.jp
#大木町	town.ooki.fukuoka.jp
広川町	town.hirokawa.fukuoka.jp
香春町	town.kawara.fukuoka.jp
添田町	town.soeda.fukuoka.jp
#糸田町	town.itoda.fukuoka.jp
#川崎町	town.kawasaki.fukuoka.jp
#大任町	town.ooto.fukuoka.jp
#赤村	vill.aka.fukuoka.jp
福智町	town.fukuchi.fukuoka.jp
#苅田町	town.kanda.fukuoka.jp
みやこ町	town.miyako.fukuoka.jp
#吉富町	town.yoshitomi.fukuoka.jp
#上毛町	town.koge.fukuoka.jp
築上町	town.chikujo.fukuoka.jp
