佐賀市	city.saga.saga.jp
唐津市	city.karatsu.saga.jp
#鳥栖市	city.tosu.saga.jp
多久市	city.taku.saga.jp
伊万里市	city.imari.saga.jp
#武雄市	city.takeo.saga.jp
鹿島市	city.kashima.saga.jp
小城市	city.ogi.saga.jp
#嬉野市	city.ureshino.saga.jp
神埼市	city.kanzaki.saga.jp
吉野ヶ里町	town.yoshinogari.saga.jp
基山町	town.kiyama.saga.jp
#上峰町	town.kamimine.saga.jp
#みやき町	town.miyaki.saga.jp
玄海町	town.genkai.saga.jp
有田町	town.arita.saga.jp
大町町	town.omachi.saga.jp
江北町	town.kouhoku.saga.jp
白石町	town.shiroishi.saga.jp
太良町	town.tara.saga.jp
