盛岡市	www.city.morioka.iwate.jp
宮古市	www.city.miyako.iwate.jp
大船渡市	www.city.ofunato.iwate.jp
花巻市	www.city.hanamaki.iwate.jp
北上市	www.city.kitakami.iwate.jp
久慈市	www.city.kuji.iwate.jp
遠野市	www.city.tono.iwate.jp
一関市	www.city.ichinoseki.iwate.jp
陸前高田市	www.city.rikuzentakata.iwate.jp
釜石市	www.city.kamaishi.iwate.jp
二戸市	www.city.ninohe.lg.jp
八幡平市	www.city.hachimantai.lg.jp
奥州市	www.city.oshu.iwate.jp
滝沢市	www.city.takizawa.iwate.jp
雫石町	www.town.shizukuishi.iwate.jp
葛巻町	www.town.kuzumaki.iwate.jp
岩手町	town.iwate.iwate.jp
紫波町	www.town.shiwa.iwate.jp
矢巾町	www.town.yahaba.iwate.jp
西和賀町	www.town.nishiwaga.lg.jp
金ケ崎町	www.town.kanegasaki.iwate.jp
平泉町	www.town.hiraizumi.iwate.jp
住田町	www.town.sumita.iwate.jp
大槌町	www.town.otsuchi.iwate.jp
山田町	www.town.yamada.iwate.jp
岩泉町	www.town.iwaizumi.lg.jp
田野畑村	www.vill.tanohata.iwate.jp
普代村	www.vill.fudai.iwate.jp
軽米町	www.town.karumai.iwate.jp
野田村	www.vill.noda.iwate.jp
九戸村	www.vill.kunohe.iwate.jp
洋野町	www.town.hirono.iwate.jp
一戸町	www.town.ichinohe.iwate.jp