秋田市	www.city.akita.lg.jp
能代市	www.city.noshiro.lg.jp
横手市	www.city.yokote.lg.jp
大館市	www.city.odate.lg.jp
男鹿市	www.city.oga.akita.jp
湯沢市	www.city-yuzawa.jp
鹿角市	www.city.kazuno.akita.jp
由利本荘市	www.city.yurihonjo.lg.jp
潟上市	www.city.katagami.lg.jp
大仙市	www.city.daisen.lg.jp
北秋田市	www.city.kitaakita.akita.jp
にかほ市	www.city.nikaho.akita.jp
仙北市	www.city.semboku.akita.jp
小坂町	www.town.kosaka.akita.jp
上小阿仁村	www.vill.kamikoani.akita.jp
藤里町	www.town.fujisato.akita.jp
三種町	www.town.mitane.akita.jp
八峰町	www.town.happou.akita.jp
五城目町	www.town.gojome.akita.jp
八郎潟町	www.town.hachirogata.akita.jp
井川町	www.town.ikawa.akita.jp
大潟村	www.vill.ogata.akita.jp
美郷町	www.town.misato.akita.jp
羽後町	www.town.ugo.lg.jp
東成瀬村	www.higashinaruse.com