福島市	www.city.fukushima.fukushima.jp
会津若松市	www.city.aizuwakamatsu.fukushima.jp
郡山市	www.city.koriyama.lg.jp
いわき市	www.city.iwaki.lg.jp
白河市	www.city.shirakawa.fukushima.jp
須賀川市	www.city.sukagawa.fukushima.jp
喜多方市	www.city.kitakata.fukushima.jp
相馬市	www.city.soma.fukushima.jp
二本松市	www.city.nihonmatsu.lg.jp
田村市	www.city.tamura.lg.jp
南相馬市	www.city.minamisoma.lg.jp
伊達市	www.city.fukushima-date.lg.jp
本宮市	www.city.motomiya.lg.jp
桑折町	www.town.koori.fukushima.jp
国見町	www.town.kunimi.fukushima.jp
川俣町	www.town.kawamata.lg.jp
大玉村	www.vill.otama.fukushima.jp
鏡石町	www.town.kagamiishi.fukushima.jp
天栄村	www.vill.tenei.fukushima.jp
下郷町	www.town.shimogo.fukushima.jp
檜枝岐村	www.vill.hinoemata.lg.jp
只見町	www.town.tadami.lg.jp
南会津町	www.town.minamiaizu.lg.jp
北塩原村	www.vill.kitashiobara.fukushima.jp
西会津町	www.town.nishiaizu.fukushima.jp
磐梯町	www.town.bandai.fukushima.jp
猪苗代町	www.town.inawashiro.fukushima.jp
会津坂下町	www.town.aizubange.fukushima.jp
湯川村	www.vill.yugawa.fukushima.jp
柳津町	www.town.yanaizu.fukushima.jp
三島町	www.town.mishima.fukushima.jp
金山町	www.town.kaneyama.fukushima.jp
昭和村	www.vill.showa.fukushima.jp
会津美里町	www.town.aizumisato.fukushima.jp
西郷村	www.vill.nishigo.fukushima.jp
泉崎村	www.vill.izumizaki.fukushima.jp
中島村	www.vill-nakajima.jp
矢吹町	www.town.yabuki.fukushima.jp
棚倉町	www.town.tanagura.fukushima.jp
矢祭町	www.town.yamatsuri.fukushima.jp
塙町	www.town.hanawa.fukushima.jp
鮫川村	www.vill.samegawa.fukushima.jp
石川町	www.town.ishikawa.fukushima.jp
玉川村	www.vill.tamakawa.fukushima.jp
平田村	www.vill.hirata.fukushima.jp
浅川町	www.town.asakawa.fukushima.jp
古殿町	www.town.furudono.fukushima.jp
三春町	www.town.miharu.fukushima.jp
小野町	www.town.ono.fukushima.jp
広野町	www.town.hirono.fukushima.jp
楢葉町	www.town.naraha.lg.jp
富岡町	www.tomioka-town.jp
川内村	www.kawauchimura.jp
大熊町	www.town.okuma.fukushima.jp
双葉町	www.town.fukushima-futaba.lg.jp
浪江町	www.town.namie.fukushima.jp
葛尾村	www.katsurao.org
新地町	www.shinchi-town.jp
飯舘村	www.vill.iitate.fukushima.jp