水戸市	www.city.mito.lg.jp
日立市	www.city.hitachi.lg.jp
土浦市	www.city.tsuchiura.lg.jp
古河市	www.city.ibaraki-koga.lg.jp
石岡市	www.city.ishioka.lg.jp
結城市	www.city.yuki.lg.jp
龍ケ崎市	www.city.ryugasaki.ibaraki.jp
下妻市	www.city.shimotsuma.lg.jp
常総市	www.city.joso.lg.jp
常陸太田市	www.city.hitachiota.ibaraki.jp
高萩市	www.city.takahagi.ibaraki.jp
北茨城市	www.city.kitaibaraki.lg.jp
笠間市	www.city.kasama.lg.jp
取手市	www.city.toride.ibaraki.jp
牛久市	www.city.ushiku.lg.jp
つくば市	www.city.tsukuba.lg.jp
ひたちなか市	www.city.hitachinaka.lg.jp
鹿嶋市	city.kashima.ibaraki.jp
潮来市	www.city.itako.lg.jp
守谷市	www.city.moriya.ibaraki.jp
常陸大宮市	www.city.hitachiomiya.lg.jp
那珂市	www.city.naka.lg.jp
筑西市	www.city.chikusei.lg.jp
坂東市	www.city.bando.lg.jp
稲敷市	www.city.inashiki.lg.jp
かすみがうら市	www.city.kasumigaura.lg.jp
桜川市	www.city.sakuragawa.lg.jp
神栖市	www.city.kamisu.ibaraki.jp
行方市	www.city.namegata.ibaraki.jp
鉾田市	www.city.hokota.lg.jp
つくばみらい市	www.city.tsukubamirai.lg.jp
小美玉市	www.city.omitama.lg.jp
茨城町	www.town.ibaraki.lg.jp
大洗町	www.town.oarai.lg.jp
城里町	www.town.shirosato.lg.jp
東海村	www.vill.tokai.ibaraki.jp
大子町	www.town.daigo.ibaraki.jp
美浦村	www.vill.miho.lg.jp
阿見町	www.town.ami.lg.jp
河内町	www.town.ibaraki-kawachi.lg.jp
八千代町	www.town.ibaraki-yachiyo.lg.jp
五霞町	www.town.goka.lg.jp
境町	www.town.ibaraki-sakai.lg.jp
利根町	www.town.tone.ibaraki.jp
