宇都宮市	www.city.utsunomiya.tochigi.jp
足利市	www.city.ashikaga.tochigi.jp
栃木市	www.city.tochigi.lg.jp
佐野市	www.city.sano.lg.jp
鹿沼市	www.city.kanuma.tochigi.jp
日光市	www.city.nikko.lg.jp
小山市	www.city.oyama.tochigi.jp
真岡市	www.city.moka.lg.jp
大田原市	www.city.ohtawara.tochigi.jp
矢板市	www.city.yaita.tochigi.jp
那須塩原市	www.city.nasushiobara.lg.jp
さくら市	www.city.tochigi-sakura.lg.jp
那須烏山市	www.city.nasukarasuyama.lg.jp
下野市	www.city.shimotsuke.lg.jp
上三川町	www.town.kaminokawa.lg.jp
益子町	www.town.mashiko.tochigi.jp
茂木町	www.town.motegi.tochigi.jp
市貝町	www.town.ichikai.tochigi.jp
芳賀町	www.town.tochigi-haga.lg.jp
壬生町	www.town.mibu.tochigi.jp
野木町	www.town.nogi.lg.jp
塩谷町	www.town.shioya.tochigi.jp
高根沢町	www.town.takanezawa.tochigi.jp
那須町	www.town.nasu.lg.jp
那珂川町	www.town.tochigi-nakagawa.lg.jp