さいたま市	www.city.saitama.jp
川越市	www.city.kawagoe.saitama.jp
熊谷市	www.city.kumagaya.lg.jp
川口市	www.city.kawaguchi.lg.jp
行田市	www.city.gyoda.lg.jp
秩父市	www.city.chichibu.lg.jp
所沢市	www.city.tokorozawa.saitama.jp
飯能市	www.city.hanno.lg.jp
加須市	www.city.kazo.lg.jp
本庄市	www.city.honjo.lg.jp
東松山市	www.city.higashimatsuyama.lg.jp
春日部市	www.city.kasukabe.lg.jp
狭山市	www.city.sayama.saitama.jp
羽生市	www.city.hanyu.lg.jp
鴻巣市	www.city.kounosu.saitama.jp
深谷市	www.city.fukaya.saitama.jp
上尾市	www.city.ageo.lg.jp
草加市	www.city.soka.saitama.jp
越谷市	www.city.koshigaya.saitama.jp
蕨市	www.city.warabi.saitama.jp
戸田市	www.city.toda.saitama.jp
入間市	www.city.iruma.saitama.jp
朝霞市	www.city.asaka.lg.jp
志木市	www.city.shiki.lg.jp
和光市	www.city.wako.lg.jp
新座市	www.city.niiza.lg.jp
桶川市	www.city.okegawa.lg.jp
久喜市	www.city.kuki.lg.jp
北本市	www.city.kitamoto.lg.jp
八潮市	www.city.yashio.lg.jp
富士見市	www.city.fujimi.saitama.jp
三郷市	www.city.misato.lg.jp
蓮田市	www.city.hasuda.saitama.jp
坂戸市	www.city.sakado.lg.jp
幸手市	www.city.satte.lg.jp
鶴ヶ島市	www.city.tsurugashima.lg.jp
日高市	www.city.hidaka.lg.jp
吉川市	www.city.yoshikawa.saitama.jp
ふじみ野市	www.city.fujimino.saitama.jp
白岡市	www.city.shiraoka.lg.jp
伊奈町	www.town.saitama-ina.lg.jp
三芳町	www.town.saitama-miyoshi.lg.jp
毛呂山町	www.town.moroyama.saitama.jp
越生町	www.town.ogose.saitama.jp
滑川町	www.town.namegawa.saitama.jp
嵐山町	www.town.ranzan.saitama.jp
小川町	www.town.ogawa.saitama.jp
川島町	www.town.kawajima.saitama.jp
吉見町	www.town.yoshimi.saitama.jp
鳩山町	www.town.hatoyama.saitama.jp
ときがわ町	www.town.tokigawa.lg.jp
横瀬町	www.town.yokoze.saitama.jp
皆野町	www.town.minano.saitama.jp
長瀞町	www.town.nagatoro.saitama.jp
小鹿野町	www.town.ogano.lg.jp
東秩父村	www.vill.higashichichibu.saitama.jp
美里町	www.town.saitama-misato.lg.jp
神川町	www.town.kamikawa.saitama.jp
上里町	www.town.kamisato.saitama.jp
寄居町	www.town.yorii.saitama.jp
宮代町	www.town.miyashiro.lg.jp
杉戸町	www.town.sugito.lg.jp
松伏町	www.town.matsubushi.saitama.jp