横浜市	www.city.yokohama.lg.jp
川崎市	www.city.kawasaki.jp
相模原市	www.city.sagamihara.kanagawa.jp
横須賀市	www.city.yokosuka.kanagawa.jp
平塚市	www.city.hiratsuka.kanagawa.jp
鎌倉市	www.city.kamakura.kanagawa.jp
藤沢市	www.city.fujisawa.kanagawa.jp
小田原市	www.city.odawara.kanagawa.jp
茅ヶ崎市	www.city.chigasaki.kanagawa.jp
逗子市	www.city.zushi.kanagawa.jp
三浦市	www.city.miura.kanagawa.jp
秦野市	www.city.hadano.kanagawa.jp
厚木市	www.city.atsugi.kanagawa.jp
大和市	www.city.yamato.lg.jp
伊勢原市	www.city.isehara.kanagawa.jp
海老名市	www.city.ebina.kanagawa.jp
座間市	www.city.zama.kanagawa.jp
南足柄市	www.city.minamiashigara.kanagawa.jp
綾瀬市	www.city.ayase.kanagawa.jp
葉山町	www.town.hayama.lg.jp
寒川町	www.town.samukawa.kanagawa.jp
大磯町	www.town.oiso.kanagawa.jp
二宮町	www.town.ninomiya.kanagawa.jp
中井町	www.town.nakai.kanagawa.jp
大井町	www.town.oi.kanagawa.jp
松田町	town.matsuda.kanagawa.jp
山北町	www.town.yamakita.kanagawa.jp
開成町	www.town.kaisei.kanagawa.jp
箱根町	www.town.hakone.kanagawa.jp
真鶴町	www.town.manazuru.kanagawa.jp
湯河原町	www.town.yugawara.kanagawa.jp
愛川町	www.town.aikawa.kanagawa.jp
清川村	www.town.kiyokawa.kanagawa.jp