岐阜市	www.city.gifu.lg.jp
大垣市	www.city.ogaki.lg.jp
高山市	www.city.takayama.lg.jp
多治見市	www.city.tajimi.lg.jp
関市	www.city.seki.lg.jp
中津川市	www.city.nakatsugawa.lg.jp
美濃市	www.city.mino.gifu.jp
瑞浪市	www.city.mizunami.lg.jp
羽島市	www.city.hashima.lg.jp
恵那市	www.city.ena.lg.jp
美濃加茂市	www.city.minokamo.gifu.jp
土岐市	www.city.toki.lg.jp
各務原市	www.city.kakamigahara.lg.jp
可児市	www.city.kani.lg.jp
山県市	www.city.yamagata.gifu.jp
瑞穂市	www.city.mizuho.lg.jp
飛騨市	www.city.hida.gifu.jp
本巣市	www.city.motosu.lg.jp
郡上市	www.city.gujo.gifu.jp
下呂市	www.city.gero.lg.jp
海津市	www.city.kaizu.lg.jp
岐南町	www.town.ginan.lg.jp
笠松町	www.town.kasamatsu.gifu.jp
養老町	www.town.yoro.gifu.jp
垂井町	www.town.tarui.lg.jp
関ケ原町	www.town.sekigahara.gifu.jp
神戸町	www.town.godo.gifu.jp
輪之内町	town.wanouchi.gifu.jp
安八町	www.town.anpachi.gifu.jp
揖斐川町	www.town.ibigawa.lg.jp
大野町	www.town-ono.jp
池田町	www.town.gifu-ikeda.lg.jp
北方町	www.town.kitagata.gifu.jp
坂祝町	www.town.sakahogi.gifu.jp
富加町	www.town.tomika.gifu.jp
川辺町	www.kawabe-gifu.jp
七宗町	www.hichiso.jp
八百津町	www.town.yaotsu.lg.jp
白川町	www.town.shirakawa.lg.jp
東白川村	www.vill.higashishirakawa.gifu.jp
御嵩町	www.town.mitake.lg.jp
白川村	shirakawa-go.org