名古屋市	www.city.nagoya.jp
豊橋市	www.city.toyohashi.lg.jp
岡崎市	www.city.okazaki.lg.jp
一宮市	www.city.ichinomiya.aichi.jp
瀬戸市	www.city.seto.aichi.jp
半田市	www.city.handa.lg.jp
春日井市	www.city.kasugai.lg.jp
豊川市	www.city.toyokawa.lg.jp
津島市	www.city.tsushima.lg.jp
碧南市	www.city.hekinan.lg.jp
刈谷市	www.city.kariya.lg.jp
豊田市	www.city.toyota.aichi.jp
安城市	www.city.anjo.aichi.jp
西尾市	www.city.nishio.aichi.jp
蒲郡市	www.city.gamagori.lg.jp
犬山市	www.city.inuyama.aichi.jp
常滑市	www.city.tokoname.aichi.jp
江南市	www.city.konan.lg.jp
小牧市	www.city.komaki.aichi.jp
稲沢市	www.city.inazawa.aichi.jp
新城市	www.city.shinshiro.lg.jp
東海市	www.city.tokai.aichi.jp
大府市	www.city.obu.aichi.jp
知多市	www.city.chita.lg.jp
知立市	www.city.chiryu.aichi.jp
尾張旭市	www.city.owariasahi.lg.jp
高浜市	www.city.takahama.lg.jp
岩倉市	www.city.iwakura.aichi.jp
豊明市	www.city.toyoake.lg.jp
日進市	www.city.nisshin.lg.jp
田原市	www.city.tahara.aichi.jp
愛西市	www.city.aisai.lg.jp
清須市	www.city.kiyosu.aichi.jp
北名古屋市	www.city.kitanagoya.lg.jp
弥富市	www.city.yatomi.lg.jp
みよし市	www.city.aichi-miyoshi.lg.jp
あま市	www.city.ama.aichi.jp
長久手市	www.city.nagakute.lg.jp
東郷町	www.town.aichi-togo.lg.jp
豊山町	www.town.toyoyama.lg.jp
大口町	www.town.oguchi.lg.jp
扶桑町	www.town.fuso.lg.jp
大治町	www.town.oharu.aichi.jp
蟹江町	www.town.kanie.aichi.jp
飛島村	www.vill.tobishima.aichi.jp
阿久比町	www.town.agui.lg.jp
東浦町	www.town.aichi-higashiura.lg.jp
南知多町	www.town.minamichita.lg.jp
美浜町	www.town.aichi-mihama.lg.jp
武豊町	www.town.taketoyo.lg.jp
幸田町	www.town.kota.lg.jp
設楽町	www.town.shitara.lg.jp
東栄町	www.town.toei.aichi.jp
豊根村	www.vill.toyone.aichi.jp