津市	www.info.city.tsu.mie.jp
四日市市	www.city.yokkaichi.lg.jp
伊勢市	www.city.ise.mie.jp
松阪市	www.city.matsusaka.mie.jp
桑名市	www.city.kuwana.lg.jp
鈴鹿市	www.city.suzuka.lg.jp
名張市	www.city.nabari.lg.jp
尾鷲市	www.city.owase.lg.jp
亀山市	www.city.kameyama.mie.jp
鳥羽市	www.city.toba.mie.jp
熊野市	www.city.kumano.lg.jp
いなべ市	www.city.inabe.mie.jp
志摩市	www.city.shima.mie.jp
伊賀市	www.city.iga.lg.jp
木曽岬町	www.town.kisosaki.lg.jp
東員町	www.town.toin.lg.jp
菰野町	www.town.komono.mie.jp
朝日町	www.town.asahi.mie.jp
川越町	www.town.kawagoe.mie.jp
多気町	www.town.taki.mie.jp
明和町	www.town.meiwa.mie.jp
大台町	www.odaitown.jp
玉城町	kizuna.town.tamaki.mie.jp
度会町	www.town.watarai.lg.jp
大紀町	www.town.taiki.mie.jp
南伊勢町	www.town.minamiise.lg.jp
紀北町	www.town.mie-kihoku.lg.jp
御浜町	www.town.mihama.mie.jp
紀宝町	www.town.kiho.lg.jp
