京都市	www.city.kyoto.lg.jp
福知山市	www.city.fukuchiyama.lg.jp
舞鶴市	www.city.maizuru.kyoto.jp
綾部市	www.city.ayabe.lg.jp
宇治市	www.city.uji.kyoto.jp
宮津市	www.city.miyazu.kyoto.jp
亀岡市	www.city.kameoka.kyoto.jp
城陽市	www.city.joyo.kyoto.jp
向日市	www.city.muko.kyoto.jp
長岡京市	www.city.nagaokakyo.lg.jp
八幡市	www.city.yawata.kyoto.jp
京田辺市	www.kyotanabe.jp
京丹後市	www.city.kyotango.lg.jp
南丹市	www.city.nantan.kyoto.jp
木津川市	www.city.kizugawa.lg.jp
大山崎町	www.town.oyamazaki.kyoto.jp
久御山町	www.town.kumiyama.lg.jp
井手町	www.town.ide.kyoto.jp
宇治田原町	www.town.ujitawara.kyoto.jp
笠置町	www.town.kasagi.lg.jp
和束町	www.town.wazuka.lg.jp
精華町	www.town.seika.kyoto.jp
南山城村	www.vill.minamiyamashiro.lg.jp
京丹波町	www.town.kyotamba.kyoto.jp
伊根町	www.town.ine.kyoto.jp
与謝野町	www.town.yosano.lg.jp
