和歌山市	www.city.wakayama.wakayama.jp
海南市	www.city.kainan.lg.jp
橋本市	www.city.hashimoto.lg.jp
有田市	www.city.arida.lg.jp
御坊市	www.city.gobo.wakayama.jp
田辺市	www.city.tanabe.lg.jp
新宮市	www.city.shingu.lg.jp
紀の川市	www.city.kinokawa.lg.jp
岩出市	www.city.iwade.lg.jp
紀美野町	www.town.kimino.wakayama.jp
かつらぎ町	www.town.katsuragi.wakayama.jp
九度山町	www.town.kudoyama.wakayama.jp
高野町	www.town.koya.wakayama.jp
湯浅町	www.town.yuasa.wakayama.jp
広川町	www.town.hirogawa.wakayama.jp
有田川町	www.town.aridagawa.lg.jp
美浜町	www.town.mihama.wakayama.jp
日高町	www.town.wakayama-hidaka.lg.jp
由良町	www.town.yura.wakayama.jp
印南町	www.town.wakayama-inami.lg.jp
みなべ町	www.town.minabe.lg.jp
日高川町	www.town.hidakagawa.lg.jp
白浜町	www.town.shirahama.wakayama.jp
上富田町	www.town.kamitonda.lg.jp
すさみ町	www.town.susami.lg.jp
那智勝浦町	www.town.nachikatsuura.wakayama.jp
太地町	www.town.taiji.wakayama.jp
古座川町	www.town.kozagawa.wakayama.jp
北山村	www.vill.kitayama.wakayama.jp
串本町	www.town.kushimoto.wakayama.jp