徳島市	www.city.tokushima.tokushima.jp
鳴門市	www.city.naruto.tokushima.jp
小松島市	www.city.komatsushima.lg.jp
阿南市	www.city.anan.tokushima.jp
吉野川市	www.city.yoshinogawa.lg.jp
阿波市	www.city.awa.lg.jp
美馬市	www.city.mima.lg.jp
三好市	www.miyoshi.i-tokushima.jp
勝浦町	www.town.katsuura.lg.jp
上勝町	www.kamikatsu.jp
佐那河内村	www.vill.sanagochi.lg.jp
石井町	www.town.ishii.lg.jp
神山町	www.town.kamiyama.lg.jp
那賀町	www.town.tokushima-naka.lg.jp
牟岐町	www.town.tokushima-mugi.lg.jp
美波町	www.town.minami.lg.jp
海陽町	www.town.kaiyo.lg.jp
松茂町	www.town.matsushige.tokushima.jp
北島町	www.town.kitajima.lg.jp
藍住町	www.town.aizumi.lg.jp
板野町	www.town.itano.tokushima.jp
上板町	www.townkamiita.jp
つるぎ町	www.town.tokushima-tsurugi.lg.jp
東みよし町	www.town.higashimiyoshi.lg.jp