長崎市	www.city.nagasaki.lg.jp
佐世保市	www.city.sasebo.lg.jp
島原市	www.city.shimabara.lg.jp
諫早市	www.city.isahaya.nagasaki.jp
大村市	www.city.omura.nagasaki.jp
平戸市	www.city.hirado.nagasaki.jp
松浦市	www.city-matsuura.jp
対馬市	www.city.tsushima.nagasaki.jp
壱岐市	www.city.iki.nagasaki.jp
五島市	www.city.goto.nagasaki.jp
西海市	www.city.saikai.nagasaki.jp
雲仙市	www.city.unzen.nagasaki.jp
南島原市	www.city.minamishimabara.lg.jp
長与町	webtown.nagayo.jp
時津町	www.town.togitsu.nagasaki.jp
東彼杵町	www.town.higashisonogi.lg.jp
川棚町	www.kawatana.jp
波佐見町	www.town.hasami.lg.jp
小値賀町	ojika.net
佐々町	www.sazacho-nagasaki.jp
新上五島町	official.shinkamigoto.net