熊本市	www.city.kumamoto.jp
八代市	www.city.yatsushiro.lg.jp
人吉市	www.city.hitoyoshi.lg.jp
荒尾市	www.city.arao.lg.jp
水俣市	www.city.minamata.lg.jp
玉名市	www.city.tamana.lg.jp
山鹿市	www.city.yamaga.kumamoto.jp
菊池市	www.city.kikuchi.lg.jp
宇土市	www.city.uto.lg.jp
上天草市	www.city.kamiamakusa.kumamoto.jp
宇城市	www.city.uki.kumamoto.jp
阿蘇市	www.city.aso.kumamoto.jp
天草市	www.city.amakusa.kumamoto.jp
合志市	www.city.koshi.lg.jp
美里町	www.town.kumamoto-misato.lg.jp
玉東町	www.town.gyokuto.kumamoto.jp
南関町	www.town.nankan.lg.jp
長洲町	www.town.nagasu.lg.jp
和水町	www.town.nagomi.lg.jp
大津町	www.town.ozu.kumamoto.jp
菊陽町	www.town.kikuyo.lg.jp
南小国町	www.town.minamioguni.lg.jp
小国町	www.town.kumamoto-oguni.lg.jp
産山村	www.ubuyama-v.jp
高森町	town.takamori.kumamoto.jp
西原村	www.vill.nishihara.kumamoto.jp
南阿蘇村	www.vill.minamiaso.lg.jp
御船町	www.town.mifune.kumamoto.jp
嘉島町	www.town.kumamoto-kashima.lg.jp
益城町	www.town.mashiki.lg.jp
甲佐町	www.town.kosa.lg.jp
山都町	www.town.kumamoto-yamato.lg.jp
氷川町	www.town.hikawa.kumamoto.jp
芦北町	www.ashikita-t.kumamoto-sgn.jp
津奈木町	www.town.tsunagi.lg.jp
錦町	www.nishiki-machi.com
多良木町	www.town.taragi.lg.jp
湯前町	www.town.yunomae.lg.jp
水上村	www.vill.mizukami.lg.jp
相良村	www.vill.sagara.lg.jp
五木村	www.vill.itsuki.lg.jp
山江村	www.vill.yamae.lg.jp
球磨村	www.kumamura.com
あさぎり町	www.town.asagiri.lg.jp
苓北町	reihoku-kumamoto.jp