宮崎市	www.city.miyazaki.miyazaki.jp
都城市	www.city.miyakonojo.miyazaki.jp
延岡市	www.city.nobeoka.miyazaki.jp
日南市	www.city.nichinan.lg.jp
小林市	www.city.kobayashi.lg.jp
日向市	www.hyugacity.jp
串間市	www.city.kushima.lg.jp
西都市	www.city.saito.lg.jp
えびの市	www.city.ebino.lg.jp
三股町	www.town.mimata.lg.jp
高原町	www.town.takaharu.lg.jp
国富町	www.town.kunitomi.miyazaki.jp
綾町	www.town.aya.miyazaki.jp
高鍋町	www.town.takanabe.lg.jp
新富町	www.town.shintomi.lg.jp
西米良村	www.vill.nishimera.lg.jp
木城町	www.town.kijo.lg.jp
川南町	www.town.kawaminami.miyazaki.jp
都農町	www.town.tsuno.lg.jp
門川町	www.town.kadogawa.lg.jp
諸塚村	www.vill.morotsuka.miyazaki.jp
椎葉村	www.vill.shiiba.miyazaki.jp
美郷町	www.town.miyazaki-misato.lg.jp
高千穂町	www.town-takachiho.jp
日之影町	www.town.hinokage.lg.jp
五ヶ瀬町	www.town.gokase.miyazaki.jp
