鹿児島市	www.city.kagoshima.lg.jp
鹿屋市	www.city.kanoya.lg.jp
枕崎市	www.city.makurazaki.lg.jp
阿久根市	www.city.akune.lg.jp
出水市	www.city.kagoshima-izumi.lg.jp
指宿市	www.city.ibusuki.lg.jp
西之表市	www.city.nishinoomote.lg.jp
垂水市	www.city.tarumizu.lg.jp
薩摩川内市	www.city.satsumasendai.lg.jp
日置市	www.city.hioki.kagoshima.jp
曽於市	www.city.soo.kagoshima.jp
霧島市	www.city-kirishima.jp
いちき串木野市	www.city.ichikikushikino.lg.jp
南さつま市	www.city.minamisatsuma.lg.jp
志布志市	www.city.shibushi.lg.jp
奄美市	www.city.amami.lg.jp
南九州市	www.city.minamikyushu.lg.jp
伊佐市	www.city.isa.kagoshima.jp
姶良市	www.city.aira.lg.jp
三島村	mishimamura.com
十島村	www.tokara.jp
さつま町	www.satsuma-net.jp
長島町	www.town.nagashima.lg.jp
湧水町	www.town.yusui.kagoshima.jp
大崎町	www.town.kagoshima-osaki.lg.jp
東串良町	www.higashikushira.com
錦江町	www.town.kinko.lg.jp
南大隅町	www.town.minamiosumi.lg.jp
肝付町	kimotsuki-town.jp
中種子町	town.nakatane.kagoshima.jp
南種子町	www.town.minamitane.kagoshima.jp
屋久島町	www.town.yakushima.kagoshima.jp
大和村	www.vill.yamato.lg.jp
宇検村	www.uken.net
瀬戸内町	www.town.setouchi.lg.jp
龍郷町	www.town.tatsugo.lg.jp
喜界町	www.town.kikai.lg.jp
徳之島町	www.tokunoshima-town.org
天城町	www.town.amagi.lg.jp
伊仙町	www.town.isen.kagoshima.jp
和泊町	www.town.wadomari.lg.jp
知名町	www.town.china.lg.jp
与論町	www.yoron.jp
