長野市	www.city.nagano.nagano.jp
松本市	www.city.matsumoto.nagano.jp
上田市	www.city.ueda.nagano.jp
岡谷市	www.city.okaya.lg.jp
飯田市	www.city.iida.lg.jp
諏訪市	www.city.suwa.lg.jp
須坂市	www.city.suzaka.nagano.jp
小諸市	www.city.komoro.lg.jp
伊那市	www.inacity.jp
駒ヶ根市	www.city.komagane.nagano.jp
中野市	www.city.nakano.nagano.jp
大町市	www.city.omachi.nagano.jp
飯山市	www.city.iiyama.nagano.jp
茅野市	www.city.chino.lg.jp
塩尻市	www.city.shiojiri.lg.jp
佐久市	www.city.saku.nagano.jp
千曲市	www.city.chikuma.lg.jp
東御市	www.city.tomi.nagano.jp
安曇野市	www.city.azumino.nagano.jp
小海町	www.koumi-town.jp
川上村	www.vill.kawakami.nagano.jp
南牧村	www.minamimakimura.jp
南相木村	www.minamiaiki.jp
北相木村	vill.kitaaiki.nagano.jp
佐久穂町	www.town.sakuho.nagano.jp
軽井沢町	www.town.karuizawa.lg.jp
御代田町	www.town.miyota.nagano.jp
立科町	www.town.tateshina.nagano.jp
青木村	www.vill.aoki.nagano.jp
長和町	town.nagawa.nagano.jp
下諏訪町	www.town.shimosuwa.lg.jp
富士見町	www.town.fujimi.lg.jp
原村	www.vill.hara.lg.jp
辰野町	www.town.tatsuno.nagano.jp
箕輪町	www.town.minowa.lg.jp
飯島町	www.town.iijima.lg.jp
南箕輪村	www.vill.minamiminowa.lg.jp
中川村	www.vill.nakagawa.nagano.jp
宮田村	www.vill.miyada.nagano.jp
松川町	www.town.matsukawa.lg.jp
高森町	www.town.nagano-takamori.lg.jp
阿南町	www.town.anan.nagano.jp
阿智村	www.vill.achi.lg.jp
平谷村	hirayamura.jp
根羽村	nebamura.jp
下條村	www.vill-shimojo.jp
売木村	www.urugi.jp
天龍村	www.vill-tenryu.jp
泰阜村	vill.yasuoka.nagano.jp
喬木村	www.vill.takagi.nagano.jp
豊丘村	www.vill.nagano-toyooka.lg.jp
大鹿村	www.vill.ooshika.nagano.jp
上松町	www.town.agematsu.nagano.jp
南木曽町	www.town.nagiso.nagano.jp
木祖村	www.vill.kiso.nagano.jp
王滝村	www.vill.otaki.nagano.jp
大桑村	www.vill.ookuwa.nagano.jp
木曽町	www.town-kiso.com
麻績村	www.vill.omi.nagano.jp
生坂村	www.village.ikusaka.nagano.jp
山形村	www.vill.yamagata.nagano.jp
朝日村	www.vill.asahi.nagano.jp
筑北村	www.vill.chikuhoku.lg.jp
池田町	www.ikedamachi.net
松川村	www.vill.matsukawa.nagano.jp
白馬村	www.vill.hakuba.nagano.jp
小谷村	www.vill.otari.nagano.jp
坂城町	www.town.sakaki.nagano.jp
小布施町	www.town.obuse.nagano.jp
高山村	www.vill.takayama.nagano.jp
山ノ内町	www.town.yamanouchi.nagano.jp
木島平村	www.vill.kijimadaira.lg.jp
野沢温泉村	www.vill.nozawaonsen.nagano.jp
信濃町	www.town.shinano.lg.jp
小川村	www.vill.ogawa.nagano.jp
飯綱町	www.town.iizuna.nagano.jp
栄村	www.vill.sakae.nagano.jp
