神戸市	www.city.kobe.lg.jp
姫路市	www.city.himeji.lg.jp
尼崎市	www.city.amagasaki.hyogo.jp
明石市	www.city.akashi.lg.jp
西宮市	www.nishi.or.jp
洲本市	www.city.sumoto.lg.jp
芦屋市	www.city.ashiya.lg.jp
伊丹市	www.city.itami.lg.jp
相生市	www.city.aioi.lg.jp
豊岡市	www.city.toyooka.lg.jp
加古川市	www.city.kakogawa.lg.jp
赤穂市	www.city.ako.lg.jp
西脇市	www.city.nishiwaki.lg.jp
宝塚市	www.city.takarazuka.hyogo.jp
三木市	www.city.miki.lg.jp
高砂市	www.city.takasago.lg.jp
川西市	www.city.kawanishi.hyogo.jp
小野市	www.city.ono.hyogo.jp
三田市	www.city.sanda.lg.jp
加西市	www.city.kasai.hyogo.jp
丹波篠山市	www.city.tambasasayama.lg.jp
養父市	www.city.yabu.hyogo.jp
丹波市	www.city.tamba.lg.jp
南あわじ市	www.city.minamiawaji.hyogo.jp
朝来市	www.city.asago.hyogo.jp
淡路市	www.city.awaji.lg.jp
宍粟市	www.city.shiso.lg.jp
加東市	www.city.kato.lg.jp
たつの市	www.city.tatsuno.lg.jp
猪名川町	www.town.inagawa.lg.jp
多可町	www.town.taka.lg.jp
稲美町	www.town.hyogo-inami.lg.jp
播磨町	www.town.harima.lg.jp
市川町	www.town.ichikawa.lg.jp
福崎町	www.town.fukusaki.hyogo.jp
神河町	www.town.kamikawa.hyogo.jp
太子町	www.town.hyogo-taishi.lg.jp
上郡町	www.town.kamigori.hyogo.jp
佐用町	www.town.sayo.lg.jp
香美町	www.town.mikata-kami.lg.jp
新温泉町	www.town.shinonsen.hyogo.jp
